rrrrrrrrrrruuuuurrrrrrrrrrrr

0000000000000000000000
0000000000001111111111
0000000000001000000000
0000000000001000000000
0000000000001000000000
0000000000001000000000
0000000000001000000000
1111111111111000000000
0000000000000000000000
0000000000000000000000